{
  "name": "QWERTZ",
  "mapping": {
    "-1": -1,
    "256": 256,
    "257": 257,
    "258": 258,
    "259": 259,
    "260": 260,
    "261": 261,
    "262": 262,
    "263": 263,
    "264": 264,
    "265": 265,
    "266": 266,
    "267": 267,
    "268": 268,
    "269": 269,
    "280": 280,
    "281": 281,
    "282": 282,
    "283": 283,
    "284": 284,
    "32": 32,
    "290": 290,
    "291": 291,
    "292": 292,
    "293": 293,
    "294": 294,
    "39": 39,
    "295": 295,
    "296": 296,
    "297": 297,
    "298": 298,
    "299": 299,
    "44": 44,
    "300": 300,
    "45": 45,
    "301": 301,
    "46": 46,
    "302": 302,
    "47": 47,
    "303": 303,
    "48": 48,
    "304": 304,
    "49": 49,
    "305": 305,
    "50": 50,
    "306": 306,
    "51": 51,
    "307": 307,
    "52": 52,
    "308": 308,
    "53": 53,
    "309": 309,
    "54": 54,
    "310": 310,
    "55": 55,
    "311": 311,
    "56": 56,
    "312": 312,
    "57": 57,
    "313": 313,
    "314": 314,
    "59": 59,
    "61": 61,
    "320": 320,
    "65": 65,
    "321": 321,
    "66": 66,
    "322": 322,
    "67": 67,
    "323": 323,
    "68": 68,
    "324": 324,
    "69": 69,
    "325": 325,
    "70": 70,
    "326": 326,
    "71": 71,
    "327": 327,
    "72": 72,
    "328": 328,
    "73": 73,
    "329": 329,
    "74": 74,
    "330": 330,
    "75": 75,
    "331": 331,
    "76": 76,
    "332": 332,
    "77": 77,
    "333": 333,
    "78": 78,
    "334": 334,
    "79": 79,
    "335": 335,
    "80": 80,
    "336": 336,
    "81": 81,
    "82": 82,
    "83": 83,
    "84": 84,
    "340": 340,
    "85": 85,
    "341": 341,
    "86": 86,
    "342": 342,
    "87": 87,
    "343": 343,
    "88": 88,
    "344": 344,
    "89": 90,
    "345": 345,
    "90": 89,
    "346": 346,
    "91": 91,
    "347": 347,
    "92": 92,
    "348": 348,
    "93": 93,
    "96": 96,
    "161": 161,
    "162": 162
  }
}